8 a
T...T..T 2
..T..... 2
.T...... 1
...T..T. 2
.T...... 2
..T..... 2
....T..T 1
T....... 0
3 1 1 1 2 1 0 3
